17
14
0************0
0*000000000000
0*000***0****0
0***0*0*0*00*0
0*0*0*0*0*00*0
0*0*000*0**0*0
0*0***0*00*0*0
0*000*0*00*0*0
0*0***0*00*0*0
0*0*000000*0*0
0*0*00000**0*0
0*000***0*00*0
0*0***0*0*00*0
0*0*000*0**0*0
000000000000*0
0************0
00000000000000